Call StackSMASHER|Something that, or someone who, smashes.
GUMS|(often in the plural) The flesh around the teeth.
CACOMISTLES|The ring-tailed cat, Bassariscus astutus.
CARBONIZES|To turn something to carbon, especially by heating it; to scorch or blacken.
OPERATIONISM|The doctrine that the meaning of a term consists of the operation(s) performed in defining it
DIFFERENTIATE|Something that has been differentiated or stratified.
CAGINESS|The quality of being cagey.
KLEBSIELLA|Any of the genus Klebsiella of rod-shaped bacteria, which cause many diseases in humans.
MUCHNESS|Large size or bulk; bigness; size; magnitude (large or small).
RATE|The worth of something; value.
HEADIER|Intoxicating or stupefying.
LANDLOCKED|(of a country, geographical region, etc.) Surrounded by land (having no borders with the sea).
FROWSTIER|Musty; stuffy (atmosphere)
VETCHLINGS|A leguminous climbing plant, notably:
RUMBLING|To make a low, heavy, continuous sound.
RESENTS|To feel resentment over; to consider as an affront.
CRANKPINS|The pin that attaches a connecting rod to a crank
VESTEES|A dickey, notably made to resemble a vest and be worn under a coat
MITZVAH|Any of the 613 commandments of Jewish law
REPLAYS|The replaying of (something), for example of televised footage.
FIDUCIARIES|One who holds a thing in trust for another; a trustee.
KERNELS|The core, center, or essence of an object or system.
CATABOLITE|Any substance produced during catabolism
REQUIRES|To ask (someone) for something; to request.
ERRATICS|A rock moved from one location to another, usually by a glacier.
SANS|Short for sans serif.
NONFACTOR|Something which is not a factor, or does not play a significant role.
CONTINUOS|The bass line of music, especially for a keyboard instrument, that continues throughout a work; basso continuo.
RESTRUCTURES|To change the organization of.
UNHOUSELED|Not having taken the housel.
INTITULES|To entitle; to give a title to.
UNFEIGNED|Not feigned.
DICTATION|Dictating, the process of speaking for someone else to write down the words
CONDITIONED|To subject to the process of acclimation.
KNUCKLEBALL|A pitch thrown with the ball gripped on the fingertips and released with no rotation, which travels over an unpredictable path to the plate due to micro-turbulence in the air.
SPRITZING|To spray, sprinkle, or squirt lightly.
MOOCH|An aimless stroll.
VANADATES|Any salt of vanadic acid
THEMSELVES|The reflexive case of they, the third-person plural personal pronoun. The group of people, animals or objects previously mentioned, as the object of a verb or following a preposition (also used for emphasis).
MATERIALIZE|To cause to take physical form, or to cause an object to appear.
BEFALLS|Case; instance; circumstance; event; incident; accident.
DINAR|The official currency of several countries, including Algeria, Bahrain, Iraq, Jordan, Kuwait, Libya, Serbia and Tunisia.
DISORIENTATES|To cause to lose orientation or direction.
BIPHASIC|Having two phases.
BEARER|One who, or that which, bears, sustains, or carries.
CHICLE|The milky latex of the sapodilla tree, used after coagulation as the principal ingredient of chewing gum
POINTIEST|Pointed in shape; having a point or points.
BELLIED|Having a large or prominent belly.
PALED|To turn pale; to lose colour.
ECONOMIZE|To practice being economical (by using things sparingly or in moderation, and by avoiding waste or extravagance).
VULNERABLE|More or most likely to be exposed to the chance of being attacked or harmed, either physically or emotionally.
INTHRALLED|To hold spellbound; to bewitch, charm or captivate.
SUBVERSIONS|The act of subverting or the condition of being subverted.
FAMOUSLY|In a celebrated manner.
TRAVELOGS|A description of someone's travels, given in the form of narrative, public lecture, slide show or motion picture.
UNSTEP|To remove (the mast) from a sailing vessel.
CONQUEROR|Someone who conquers
SYMPOSIASTS|One engaged with others at a banquet or merrymaking.
GALLBLADDERS|A pear-shaped organ that stores bile from the liver, until the body needs it for the digestion and absorption of fats in the duodenum.
HACKNEYS|An ordinary horse.
TROPES|Something recurring across a genre or type of art or literature, such as the ‘mad scientist’ of horror movies or the use of the phrase ‘once upon a time’ as an introduction to fairy tales; a motif.
CORROBORATING|To confirm or support something with additional evidence; to attest or vouch for.
GRAPHS|(applied mathematics) A data chart (graphical representation of data) intended to illustrate the relationship between a set (or sets) of numbers (quantities, measurements or indicative numbers) and a reference set, whose elements are indexed to those of the former set(s) and may or may not be numbers.
URTICATE|To have or produce a stinging sensation, as of nettles or urticating hair.
NEGUSES|A drink of wine, lemon, sugar, nutmeg and hot water.
QUESTIONER|A person who asks questions, or who conducts an official enquiry.
MAGNIFICENTLY|In a magnificent manner.
SCUTTLEBUTT|A butt with a scuttle, a keg of drinking water with a hole cut in it, on board ship.
INDELICACIES|The condition of being indelicate.
MEADOW|A field or pasture; a piece of land covered or cultivated with grass, usually intended to be mown for hay.
SOUSING|To immerse in liquid; to steep or drench.
ODONTOIDS|A separate bone, in many reptiles, corresponding to the odontoid process.
INGENUOUS|Naive and trusting.
ESPYING|To catch sight of; to see; to spot (said especially of something not easy to see)
SPHEROIDS|A solid of revolution generated by rotating an ellipse about its major (prolate), or minor (oblate) axis.
RITZY|Elegant and luxurious.
OSTEOLOGY|The scientific study of the morphology and pathology of bones.
ORIGINALS|An object or other creation (e.g. narrative work) from which all later copies and variations are derived
SCABS|An incrustation over a sore, wound, vesicle, or pustule, formed during healing.
TOOTHWORTS|Any of several species of flowering plants, of the genus Lathraea.
DOGMA|An authoritative principle, belief or statement of opinion, especially one considered to be absolutely true and indisputable, regardless of evidence or without evidence to support it.
ROTTERS|A worthless, despicable person.
TOOTHWORT|Any of several species of flowering plants, of the genus Lathraea.
BEAUTIFUL|Someone who is beautiful. Can be used as a term of address.
TRANSFIGURATION|A major change in appearance or form; a metamorphosis.
SUFFICIENTLY|(manner) In a sufficient manner; enough.
FIREBALLS|A ball of fire, especially one associated with an explosion.
DEHUMIDIFYING|To reduce the moisture in a body of air; to lower the humidity.
MAXIMA|A music note equal to two (or sometimes three) longæ; in modern notation, this is typically equivalent to eight semibreves.
FOREWARNING|To warn in advance.
PERSECUTE|To pursue in a manner to injure, grieve, or afflict; to beset with cruelty or malignity; to harass; especially, to afflict, harass, punish, or put to death for one's race, sexual identity, adherence to a particular religious creed, or mode of worship.
LUBRICATING|To make slippery or smooth (normally to minimize friction) by applying a lubricant.
OVERFLYING|To fly over something.
BRUSQUE|Rudely abrupt, unfriendly.
CONTROVERTS|To dispute, to argue about (something).
OVERPLUS|That which remains beyond what is necessary or required; a surplus.
HOGSHEADS|An English measure of capacity for liquids, containing 63 wine gallons, or about 52 1/2 imperial gallons; a half pipe.
GANG|To go; walk; proceed.
NONCUSTODIAL|(of a parent) Not having custody of a child.
FIREPROOFED|To make resistant to damage from fire.
ZEROES|The numeric symbol that represents the cardinal number zero.
FOREHEADS|The part of the face above the eyebrows and below the hairline.
SURVIVORS|One who survives, especially one who survives a traumatic experience.
GOBONY|Compony
PUNISHMENTS|The act or process of punishing, imposing and/or applying a sanction.
URANYL|The divalent radical UO22+, conveniently regarded as a residue of many uranium compounds.
FUSS|Excessive activity, worry, bother, or talk about something.
VINCA|Any of several evergreen shrubs, of the genus Vinca, including the periwinkle
CALCIC|Of, pertaining to, or derived from calcium or lime
TRACHYTE|A pale igneous rock consisting mostly of potassium feldspar and plagioclase.
ENGENDER|To beget (of a man); to bear or conceive (of a woman).
UNQUESTIONED|(of a person) Not subjected to an interrogation
SALINITIES|The quality of being saline.
CRANIATES|Any member of the clade Craniata, having bony skulls.
ARMPIT|The cavity beneath the junction of the arm and shoulder.
DARKNESSES|The state of being dark; lack of light.
CONDENSATE|A liquid that is the product of condensation of a gas, i.e. of steam.
BIORHYTHMS|Any cyclic biological or physiological pattern or activity
CIRCUMVALLATION|A rampart or other defensive entrenchment that entirely encircles the position being defended.
UITLANDER|A foreigner; outlander.
ISINGLASS|A form of gelatine obtained from the air bladder of the sturgeon and certain other fish, used as an adhesive and as a clarifying agent for wine and beer.
HOGS|Any animal belonging to the Suidae family of mammals, especially the pig, the warthog, and the boar.
PREPARE|Preparation
VACANT|Not occupied; empty.
KNIFE|A utensil or a tool designed for cutting, consisting of a flat piece of hard material, usually steel or other metal (the blade), usually sharpened on one edge, attached to a handle. The blade may be pointed for piercing.
INDUSTRIES|The tendency to work persistently. Diligence.
VELARS|A sound articulated at the soft palate
OUTRANGING|To have a longer range than (another projectile or weapon).
FOREORDAINING|To predestine or preordain.
UNSAID|Unspoken.
BROOMRAPE|Any of various plants, of the genus Orobanche, that are parasitic on the roots of other plants.
AGA|An honorific for high officials used in Turkey and certain Muslim countries.
FILAMENTS|A fine thread or wire.
PRONUNCIATION|The formal or informal way in which a word is made to sound when spoken.
EARMUFFS|Objects designed to cover a person's ears for protection against cold or noise. They consist of a thermoplastic or metal head-band, that fits over the top of the head, and a pad at each end, to cover the external ears.
CORRODE|To eat away bit by bit; to wear away or diminish by gradually separating or destroying small particles of, as by action of a strong acid or a caustic alkali.
SWIVETS|A state or condition of haste, flutter; extreme discomposure or distress; irritation, exasperation, annoyance.
SUNBONNETS|A hat (bonnet) worn for protection from bright sunlight.
MARTLETS|A bird, the martin.
UNSELFISH|Not selfish
LITANIES|A ritual liturgical prayer in which a series of prayers recited by a leader are alternated with responses from the congregation.
POXIER|Suffering from pox
FOXGLOVES|Digitalis, a genus of about 20 species of herbaceous biennials native to the Old World, certain of which are prized for their showy flowers. The drug digitalis or digoxin was first isolated from the plant.
SPECIALISING|To make distinct or separate, particularly:
PAMPHLET|A small booklet of printed informational matter, often unbound, having only a paper cover.
COOKIES|A small, flat, baked good which is either crisp or soft but firm.
GREETERS|A person who greets people on their arrival.
CHABLIS|A variety of dry white wine from this region
INTERCALARY|Describing a time period inserted between others; leap, (as in leap day, leap month, or leap year)
TROLLEY|A cart or shopping cart.
BAM|Representing a loud noise or heavy impact.
SENTIENT|Lifeform with the capability to feel sensation, such as pain.
UNEQUALLED|Without equal; unmatched.
CHEERLEADER|A person, usually a young, attractive female, who encourages applause and cheers at a sports event, and wearing a specially-designed uniform in the official colors of the team he/she cheers for.
BREASTPIN|An ornamental pin attached to clothing in a person's upper chest area; a brooch.
CLOTHES|A woven fabric such as used in dressing, decorating, cleaning or other practical use.
BANTERING|To engage in banter or playful conversation.
BOOTLICK|A toady or sycophant.
HOMINOIDS|Any primate (including humans and apes) belonging to the superfamily Hominoidea
DUMPED|To release, especially in large quantities and chaotic manner.
AGOUTIS|A rodent similar in appearance to a guinea pig but having longer legs, of the family Dasyprocta.
SHAYS|A chaise.
DEFICIT|Deficiency in amount or quality; a falling short; lack.
UNTAUGHT|Not taught; uneducated.
GADZOOKS|An expression of surprise, shock etc.
PEAKIEST|Sickly; peaked.
SUBSCRIBES|To sign up to have copies of a publication, such as a newspaper or a magazine, delivered for a period of time.
SHAMROCKS|The trefoil leaf of any small clover, especially Trifolium repens, or such a leaf from a clover-like plant, commonly used as a symbol of Ireland.
ARROWING|To move swiftly and directly (like an arrow)
DISBANDED|To break up or (cause to) cease to exist; to disperse.
HOARSEST|Having a dry, harsh tone to the voice, as a result of a sore throat, age, emotion, etc.
GLISTERED|To gleam, glisten or coruscate.
DANDER|Dandruff—scaly white dead skin flakes from the human scalp.
NEBULIZE|To convert liquid into a fine spray of aerosols, by using a nebulizer; to atomize
DECOMMISSIONING|To take out of service or to render unusable.
FOGGIER|Obscured by mist or fog; unclear; hazy
THUNKED|To strike against something, without breakage, making a "thunk" sound.
CABERNETS|Cabernet Sauvignon
ROAMS|To wander or travel freely and with no specific destination.
TAROTS|(singular or plural) A card game played in various different variations.
TRIENNIALS|A third anniversary.
STAGES|A phase.
IRRITABLE|Capable of being irritated.
SAUCE|A liquid (often thickened) condiment or accompaniment to food.
CHERUBIM|A winged creature attending God, described by Pseudo-Dionysius the Areopagite (c. 5th–6th century) as the second highest order of angels, ranked above thrones and below seraphim; similar to a lamassu in the pre-exilic texts of the Hebrew Bible, more humanoid in later texts.
SPECULATES|To think, meditate or reflect on a subject; to consider, to deliberate or cogitate.
MICROCIRCUITS|An electronic device, usually fabricated by photolithography, that is very small and implements several components or their equivalent; an integrated circuit.
COMPLEXES|A network of interconnected systems.
MANTAS|A kind of fabric or blanket used in Latin America and southwestern United States.
SINGULAR|(grammar) A form of a word that refers to only one person or thing.
GASTIGHT|Impermeable to gases
FANTASIED|Filled with imaginations or fancies.
EYRES|A journey in circuit of certain itinerant judges called justices in eyre (or in itinere).
HELIOGRAM|A message transmitted by a heliograph.
GRAMMA|Grandmother
MIRED|To cause or permit to become stuck in mud; to plunge or fix in mud.
RHOS|The seventeenth letter of the Modern Greek and Classical alphabets and the nineteenth letter of Old and Ancient.
CORRELATING|To compare things and bring them into a relation having corresponding characteristics
CLACHAN|A small village or hamlet, especially in the Highlands or Western Scotland.
RASPERS|A person who, or thing that, rasps or scrapes.
SUBSTITUTING|To use in place of something else, with the same function.
ALLEMANDE|A popular instrumental dance form in Baroque music, and a standard element of a suite, generally the first or second movement.
RENDEZVOUS|A meeting or date.
ALLODIA|Freehold land or property
DEPENDENT|One who relies on another for support
LYRICIST|A person who writes the lyrics of a song.
ANTIFOULING|Any substance that prevents or counteracts the buildup of barnacles and other deposits on undersea surfaces such as those of boats.
MANTLED|To cover or conceal (something); to cloak; to disguise.
FLASK|A narrow-necked vessel of metal or glass, used for various purposes; as of sheet metal, to carry gunpowder in; or of wrought iron, to contain quicksilver; or of glass, to heat water in, etc.
SHOCKINGLY|In a shocking manner.
WHITEST|Bright and colourless; reflecting equal quantities of all frequencies of visible light.
CUSPIDOR|(chiefly US) A spittoon.
SPLAKE|A hybrid fish derived from a male brook trout and a female lake trout
TABLETS|A slab of clay used for inscription.
CHICKENS|A domestic fowl, Gallus gallus, especially when young.
PULSATING|To expand and contract rhythmically; to throb or to beat.
INHALING|To draw air into the lungs, through the nose or mouth by action of the diaphragm.
OCTENNIAL|Occurring every eight years.
BIOREGIONS|An eco-region.
RETREAD|A used tire whose surface, the tread, has been replaced to extend its life and use.
ASSIMILATIONIST|An advocate of the policy or practice of the assimilation of immigrant or other minority cultures into a mainstream culture.
INHUME|To bury in a grave.
EMERGENTS|A plant whose root system grows underwater, but whose shoot, leaves and flowers grow up and above the water.
REITERATION|The act of reiterating.
CIVILIANIZING|To convert from military to civilian operation or control.
CLOTHESHORSES|A frame on which laundry is hung to dry.
CORUSCATES|To give off light; to reflect in flashes; to sparkle.
PARKING|To bring (something such as a vehicle) to a halt or store in a specified place.
SLINKING|To sneak about furtively.
ANNULLED|To formally revoke the validity of.
STAIRCASE|A flight of stairs; a stairway.
FIELDSTONE|A stone found in fields and used for building.
BOTTLERS|A person, company, or thing who bottles, especially in bulk.
REDETERMINED|To determine again
BOURSE|A stock exchange.
NOW|The present time.
TIARA|The papal crown.
GUAIACOL|A naturally occurring methoxy phenol, having certain medicinal applications
EXPLICITLY|In an explicit manner.
FIREFIGHTERS|A person who puts out fires.
WILLET|Tringa semipalmata or Catoptrophorus semipalmatus, a large shorebird.
SPADILLE|The ace of spades in omber and quadrille.
PAPPIES|Father
TWIGGED|To beat with twigs.
NEVE|Nephew.
REDIVIDE|To divide again.
PANPIPE|A set of panpipes
LUSTROUS|Having a glow or lustre.
TOMCATTED|To prowl for sexual gratification.
RANCHERS|A person who operates a ranch.
PETIOLES|The stalk of a leaf, attaching the blade to the stem.
RINGTAIL|A ring-tailed animal, notably:
FABULOUSLY|In a fabulous manner.
UNITIES|Oneness; the state or fact of being one undivided entity.
GOTHIC|Of or relating to the Goths or their language.
PHILOSOPHER|A lover of wisdom.
DIRER|Warning of bad consequences: ill-boding; portentous.
CORONARY|Any of the coronary vessels; a coronary artery or coronary vein.
BARONY|The domain of a baron or baroness, usually as part of a larger kingdom or empire.
LEAGUING|To form an association; to unite in a league or confederacy; to combine for mutual support.
HORTICULTURIST|A gardener; a person interested or practicing horticulture.
TROOPED|To move in numbers; to come or gather in crowds or troops.
MARTYRIZED|To make a martyr of (someone).
OUTSTAYS|To stay beyond or longer than.
RUTABAGA|The swede, or Swedish turnip; the European plant Brassica napus var. napobrassica
TRACED|To follow the trail of.
VOLLEYED|To fire a volley of shots
DUNAM|An Ottoman Turkish unit of surface area nominally equal to 1,600 square (Turkish) paces but actually varied at a provincial and local level according to land quality to accommodate its colloquial sense of the amount of land able to be plowed in a day, roughly equivalent to the Byzantine stremma or English acre.
MONOMERS|A relatively small molecule which can be covalently bonded to other monomers to form a polymer.
DIMLY|In a dim manner.
GROGRAM|A strong, rough fabric made up of a mixture of silk, and mohair or wool.
BOWHEAD|A large whale, Balaena mysticetus, having a large, rounded head, that inhabits Arctic waters.
CAPACITATED|To make capable of functioning in a given capacity.
IMPERILING|To put into peril; to place in danger.
PROFLIGACIES|Careless wastefulness.
ACCENT|A higher-pitched or stronger articulation of a particular syllable of a word or phrase in order to distinguish it from the others or to emphasize it.
BIOMIMETIC|Of, related to, or produced by biomimetics
CUDGELS|A short heavy club with a rounded head used as a weapon.
REPROACHING|To criticize or rebuke (someone).
PUTREFYING|To become filled with a pus-like or bile-like substance.
WHOOPS|Oops.
ROTOTILLED|To break up and turn soil using a rototiller.
SEEDING|To plant or sow an area with seeds.
COLLECTEDNESS|The state or quality of being collected.
HEARTED|To be fond of. Often bracketed or abbreviated with a heart symbol.
DOZENTH|A twelfth.
COMMERCIALISE|To apply business methodology to something in order to profit
HOUSEHOLDER|The owner of a house.
OVERSHOE|A shoe worn over an ordinary shoe, either to protect from water or mud, or to prevent damage to a floor.
TECHNOSTRUCTURE|A corporate structure including technicians or other skilled professionals
BEJEWEL|To decorate or bedeck with jewels or gems.
MUSKRAT|A large aquatic rodent (Ondatra zibethicus).
CONDUCTIVITY|The ability of a material to conduct electricity, heat, fluid or sound
JACKSCREWS|A jack (mechanical lifting device) which is operated by turning a leadscrew.
CHEAPENING|To decrease the value of; to make cheap
ASSIGN|An assignee.
ARMORER|A manufacturer of weapons, especially of guns
SURCINGLE|A long unpadded strap to pass over and keep in place a blanket, pack or saddle on an animal.
PENETRATIONS|The act of penetrating something.
BUMMING|To sodomize; to engage in anal sex.
MIXUP|A case of confusion.
LUSTRING|A glossy silk fabric; lutestring.
DYSPNEA|Difficult or labored respiration; shortness of breath.
NONCONDUCTORS|Any material that does not conduct electricity; a dielectric
INKLE|To hint at; disclose.
IRONMONGER|A retailer in iron goods and hardware
WHITEWASHES|A lime and water mixture for painting walls and fences bright white.
INFRANGIBLE|Unbreakable, indestructible, or very difficult to break.
CIRCUMAMBULATED|To walk around something in a circle, especially for a ritual purpose.
STRAGGLERS|A person who straggles, or departs from the direct or proper course, or from the company to which they belong.
YON|That (thing) over there; of something distant, but within sight.
CUMBIA|A traditional style of Colombian dance and music, or a piece in this style
TAUNTS|A scornful or mocking remark; a jeer or mockery
NOBODIES|Someone who is not important or well-known.
ADYTA|The innermost sanctuary or shrine in a temple, from where oracles were given.
CANTILEVERS|A beam anchored at one end and projecting into space, such as a long bracket projecting from a wall to support a balcony.
MULTIPLAYER|(games) The feature of a video game where multiple human players play simultaneously.
TAILLIGHT|One of a pair of red lights mounted on the rear of a vehicle, so it can be seen from the rear at night.
STYMIES|A situation where an opponent's ball is directly in the way of one's own ball and the hole, on the putting green (abolished 1952).
LUMBERS|To move clumsily and heavily; to move slowly.
SOFTWARE|Encoded computer instructions, usually modifiable (unless stored in some form of unalterable memory such as ROM).
SHOTGUNNED|(smoking) To inhale from a pipe or other smoking device, followed shortly by an exhalation into someone else’s mouth.
ROUST|A strong tide or current, especially in a narrow channel.
TRAITS|An identifying characteristic, habit or trend.
THYROTROPIN|A thyroid-stimulating glycoprotein hormone secreted by the pituitary gland
CARBIDES|Any binary compound of carbon and a more electropositive element
SHARPEST|Terminating in a point or edge, especially one that can cut easily; not obtuse or rounded.
LIQUEFACTION|Process of being, or state of having been, made liquid (from either a solid or a gas)
BACKHANDS|A stroke made across the chest from the off-hand side to the racquet hand side; a stroke during which the back of the hand faces the shot.
PREREGISTER|To register for something (especially for a course of education) prior to its start.
TANTRUM|An often childish display or fit of bad temper.
STRATEGISTS|Someone who devises strategies.
FOLLOWED|To go after; to pursue; to move behind in the same path or direction.
GENERATES|To bring into being; give rise to.
ROUX|A mixture of fat (usually butter) and flour used to thicken sauces and stews.
DOORSTOP|Any device or object used to halt the motion of a door, as a large or heavy object, a wedge, or some piece of hardware fixed to the floor, door or wall.
TREACLE|A syrupy byproduct of sugar refining; molasses or golden syrup.
DISACCHARIDE|Any sugar, such as sucrose, maltose and lactose, consisting of two monosaccharides combined together.
SECURITY|The condition of not being threatened, especially physically, psychologically, emotionally, or financially.
BARRENER|Unable to bear children; sterile.
GULL|A seabird of the genus Larus or of the family Laridae.
CHAPATI|A flat, unleavened bread from northern India and Pakistan.
PRACTICUM|A college course designed to give a student supervised practical knowledge of a subject previously studied theoretically.
MILIARY|One of the small tubercles of Echinus sea urchins.
UNCUT|Not cut.
CEILED|To line or finish (a surface, such as a wall), with plaster, stucco, thin boards, or similar.
OVERINDULGING|To indulge to excess.
MERCHANDIZES|To engage in trade; to carry on commerce.
BIOMARKER|A substance used as an indicator of a biological state, most commonly disease.
KEYSTROKE|The act of pressing an input key; a keypress on a computer keyboard or a typewriter, or a similar input device.
OARSMEN|A man who rows a boat, either alone or with others.
TWEENIES|A child who is not quite old enough to be a teenager; a tweenager.
SERPIGINOUS|Creeping, advancing
OBSOLESCENCE|The state of being obsolete—no longer in use; gone into disuse; disused or neglected.
MONUMENTAL|In the manner of a monument.
REDRAWING|To draw again.
TYROSINE|A nonessential amino acid 2-amino-3-(4-hydroxyphenyl)propanoic acid found in most animal proteins, especially casein
REANALYZED|To analyze again.
UNMOORED|Not moored.
ICHTHYIC|Of, pertaining to, or like fish; piscine.
MECHANICIAN|One skilled in the theory or construction of machines.
REASSESSES|To assess again; to revise an earlier assessment; to reevaluate
HEIST|A robbery or burglary, especially from an institution such as a bank or museum.
BECK|A stream or small river.
ROOMERS|A person who rents a room.
SPEC|A special place (for hiding or viewing)
RESPONDED|To say something in return; to answer; to reply.
CARJACKS|To steal an automobile forcibly from (someone).
TEMPERS|A tendency to be in a certain type of mood; a habitual way of thinking, behaving or reacting.
DESERVEDLY|(degree, manner) In a way or to a degree that is deserved or merited.
COLLIMATES|To focus into a narrow beam or column; to adjust a focusing device so that it produces a narrow beam.
LOGICALLY|In a logical manner, with logic.
SOUND|Healthy.
UNQUOTING|To convert (a quoted expression) back to its original form.
EXTIRPATED|To clear an area of roots and stumps.
ARPENT|A pre-metric French unit of length, having various official measures.
HIDING|To put (something) in a place where it will be harder to discover or out of sight.
CALVED|To give birth to a calf
DIPNET|To catch (fish) in a hand net.
TIPPLING|To sell alcoholic liquor by retail.
LOGINS|A combination of a user's identification and password used to enter a computer, program, network, etc.
YELPS|An abrupt, high-pitched noise or utterance.
ELECTROMETERS|A device used to detect and measure static electricity; an electroscope.
COZEN|To become cozy; (by extension) to become acquainted, comfortable, or familiar with.
TIMOLOL|A synthetic compound which acts as a beta blocker and is used to treat hypertension, migraine, and glaucoma.
FIRING|To set (something, often a building) on fire.
ENSNARLED|To entangle; to trap.
BLOWHOLE|The spiracle, on the top of the head, through which cetaceans breathe.
AIRHOLE|A hole provided for ventilation or breathing.
POTBOUND|(of a potted plant) Having outgrown the size of the pot, such that its roots have no more room to grow.
FORTHRIGHT|A straight path.
COMMODITY|Anything movable (a good) that is bought and sold.
SQUEAK|A short, high-pitched sound, as of two objects rubbing together, or the calls of small animals.
MASTHEADED|To send to the masthead as a punishment.
ENDUED|To pass food into the stomach; to digest; also figuratively, to take on, absorb.
CENOTES|A deep natural well or sinkhole, especially in Central America, formed by the collapse of surface limestone that exposes ground water underneath, and sometimes used by the ancient Mayans for sacrificial offerings.
PERSONALTY|Any property that is movable; that is, not real estate.
CAVIAR|Roe of the sturgeon or other large fish, considered a delicacy.
SALALS|A leathery-leaved North American shrub, Gaultheria shallon, with edible sepals and leaves.
REASON|A cause:
CAMARILLA|A secret, usually sinister, group of conspiring advisors close to the leadership; a cabal.
PILASTERS|A rectangular column that projects partially from the wall to which it attached; it gives the appearance of a support, but is only for decoration.
SYNDICATING|To become a syndicate.
ACCEPTOR|One who accepts.
DISFUNCTION|A failure to function in an expected or complete manner. Usually refers to a disorder in a bodily organ (e.g. erectile dysfunction), a mental disorder, or the improper behavior of a social group.
KUGELS|A traditional Jewish dish consisting of baked pudding of rice, pasta, or potatoes with vegetables or raisins and spices
APOSTATE|A person who has renounced a religion or faith.
WADING|To walk through water or something that impedes progress.
UNIONIZED|To organize workers into a union.
PERIODONTAL|Surrounding a tooth
STOP|A (usually marked) place where buses, trams or trains halt to let passengers get on and off, usually smaller than a station.
FLATLINES|(of the heart) To stop beating.
DISSENSUS|Disagreement, especially when widespread.
UNDERVEST|Vest (worn underneath a shirt)
UNFOLDS|To undo a folding.
BIRLS|A girl of boyish appearance.
HAMMERS|A tool with a heavy head and a handle used for pounding.
REEMERGED|To emerge again, to come into view after having hidden.
EFFERVESCENT|(of a liquid) Giving off bubbles; fizzy.
SHADS|Any one of several species of food fishes that make up the genus Alosa in the family Clupeidae, to which the herrings also belong; river herring.
FIREBOMBS|A weapon that causes fire, an incendiary weapon.
UNDERGRADS|An undergraduate.
MOVINGLY|In a moving manner.
HYDROLYZES|To subject to hydrolysis.
SONS|One's male offspring.
GOOGOL|The number 10^{100}, or ten to the power of a hundred.
POSTNATAL|(of a baby) after being born, of or pertaining to the period immediately after birth
FLEECES|To con or trick (someone) out of money.
SUFFERED|To undergo hardship.
CONGRUENT|Corresponding in character; congruous
RATIONALISING|To make something rational or more rational.
UNWEDDED|Not wedded.
PROSECUTING|To start criminal proceedings against.
STROLLS|A wandering on foot; an idle and leisurely walk; a ramble.
FOUND|To encounter or discover by accident; to happen upon.
PESEWAS|In the currency of Ghana, one hundredth of a cedi.
DEADFALL|Coarse woody debris; deadwood.
BEATERS|Someone or something that beats.
ANTHOLOGIZED|To compile, or include something in, an anthology.
SKIMOBILE|Snowmobile
UNCASED|Not cased; without a casing.
FOUNTAINHEAD|A spring that is the source of a river.
PLUCKED|To pull something sharply; to pull something out
CUSTOMHOUSES|An official building, in a port, where customs are collected and shipping is cleared for entry and exit
FORCEFULLY|With either physical of coercive force; in a forceful manner; vigorously; powerfully.
METAPHRASES|A literal, word-for-word translation.
BOWLEGGED|Having a bowleg
PERMS|A permanent.
POETICIZE|To make poetic, or express in poetry.
CONFECTIONS|A food item prepared very sweet, frequently decorated in fine detail, and often preserved with sugar, such as a candy, sweetmeat, fruit preserve, pastry, or cake.
HANKERS|To crave, want or desire.
VULCANIZE|To treat rubber with heat and (usually) sulphur to harden it and make it more durable.
FUNDED|To pay for.
VISCUS|One of the organs, as the brain, heart, or stomach, in the great cavities of the body of an animal; especially used in the plural, and applied to the organs contained in the abdomen.
SYCES|A groom, or servant with responsibility for the horses.
DELTAS|The fourth letter of the modern Greek alphabet Δ, δ.
JEALOUS|Suspecting rivalry in love; troubled by worries that one might have been replaced in someone's affections; suspicious of a lover's or spouse's fidelity.
QUARRELING|A heated argument.
FIGUREHEADS|A carved figure on the prow of a sailing ship.
DAYMARE|A vivid, unpleasant mental image, having the characteristics of a nightmare, during wakefulness.
CATHETERIZES|To introduce a catheter into part of the body.
BATHER|One who bathes or swims.
GRUNT|A short snorting sound, often to show disapproval, or used as a reply when one is reluctant to speak.
GREENLIT|To approve; to permit to proceed.
CUSTOMIZE|To build or alter according to personal preferences or specifications.
WINGSPANS|(usually in singular) The distance from the left wingtip to the right wingtip (of a bird, airplane etc.).
SOLES|A wooden band or yoke put around the neck of an ox or cow in the stall.
ENGROSSING|To write (a document) in large, aesthetic, and legible lettering; to make a finalized copy of.
TUNICATE|Any of very many chordate marine animals, of the subphyla Tunicata or Urochordata, including the sea squirts.
THEATRICS|Theatrical appearance or character
INTERCONNECTION|A connection (physical or logical) between multiple things
CELEBRATED|To extol or honour in a solemn manner.
PARRY|A defensive or deflective action; an act of parrying.
RUBBERNECKING|To watch by craning the neck (as though it were made of rubber), especially if the observer and observed are in motion relative to each other.
PALPITATIONS|An abnormal beating of the heart that may be perceived by the patient, a result of excitement, exertion, or illness.
PUBLICANS|The landlord of a public house.
FARAWAY|Distant.
MANIPLES|A division of the Roman army numbering 120 (or sometimes 60) soldiers exclusive of officers; (generally) any small body of soldiers.
COMPLEAT|To finish; to make done; to reach the end.
LEANED|To incline, deviate, or bend, from a vertical position; to be in a position thus inclining or deviating.
SUTURED|To sew up or join by means of a suture.
CLOTHESLINED|To knock (a person) over by striking his or her upper body or neck with one's arm, as if he or she had run into a low clothesline.
COOKING|To prepare (food) for eating by heating it, often by combining it with other ingredients.
ANTICLINE|A fold with strata sloping downwards on each side.
PURIS|A type of unleavened bread from India and Pakistan, usually deep-fried.
CLABBERS|To sour or curdle.
SCHLEPP|A long or burdensome journey.
INEGALITARIAN|One who does not support equality; a subscriber to inegalitarianism.
BIBLIOMANIA|A passion for owning valuable books.
DELIVERED|To set free from restraint or danger.
DISCOLOUR|To change or lose color.
MUNCHKIN|A domestic cat breed with short legs.
UNFORGIVABLE|Not forgivable; inexcusable.
LOCATING|To place; to set in a particular spot or position.
SYSTEMATISE|To arrange into a systematic order.
HEADGEAR|Anything worn on the head, such as a helmet.
RELIEVOS|Relief (surface carving)
ROWELLING|To use a rowel on (something), especially to drain fluid.
TEASELING|To raise the nap on cloth; to tease; to card.
CABALIST|A member of a cabal.
ESTHETICIAN|One who studies aesthetics; a student of art or beauty.
TATAMI|Straw matting, in a standard size, used as a floor covering in Japanese houses
PROSCRIBED|To forbid or prohibit.
WHEELWRIGHTS|A person who builds and repairs wheels, especially wooden spoked ones.
SWIVELED|To swing or turn, as on a pin or pivot.
CAVERN|A large cave.
CALL|A telephone conversation.
FAROUCHE|Sullen or recalcitrant.
OUTINGS|A pleasure trip or excursion.
PLUTEUS|A low screen between columns, especially one that surrounds the choir of a church
EVANGELIZED|To tell people about (a particular branch of) Christianity, especially in order to convert them; to preach the gospel to.
LABIATES|A plant of the mint family (Labiatae)
BOORS|A peasant.
PERFORATED|To pierce; to penetrate.
PENANCED|To impose penance; to punish.
OVATIONS|A victory ceremony of less importance than a triumph.
TILLS|A cash register.
INTERVIEWEE|Someone being interviewed, i.e. the person answering the questions.
COCKAMAMIE|A decal, a design that can be transferred to a surface.
GLUHWEIN|A type of mulled wine from German-speaking countries made from red wine with cinnamon and other herbs and spices.
THEATRICALIZES|To render suitable for the theatre.
HOOVERING|To clean (a room, etc.) with a vacuum cleaner, irrespective of brand.
BINUCLEATE|A cell that has two nuclei
TRITONES|An interval of three whole tones.
SUBTRACTS|To remove or reduce; especially to reduce a quantity or number
BEJEWELLING|To decorate or bedeck with jewels or gems.
SPLINING|To smooth (a curve or surface) by means of a spline.
WAGGON|A four-wheeled cart for hauling loads.
CATEGORY|A group, often named or numbered, to which items are assigned based on similarity or defined criteria.
OPENHANDED|Done with the hand open rather than clenched
CONCINNITY|The harmonious reinforcement of the various parts of a work of art.
ADMEASUREMENT|Apportionment.
NYLON|Originally, the DuPont company trade name for polyamide, a copolymer whose molecules consist of alternating diamine and dicarboxylic acid monomers bonded together; now generically used for this type of polymer.
FRUSTRATION|The feeling of annoyance when one's actions are criticized or hindered
SCHOOLMASTER|A male teacher.
INVOLUTION|Entanglement; a spiralling inwards; intricacy.
LUNGWORM|Any of several nematode worms, of the family Metastrongylidae, that are parasitic to mammalian lungs
FLAUTIST|One who plays the flute.
CURTAINING|To cover (a window) with a curtain; to hang curtains.
STANDOFFISH|Aloof; reserved; unsociable and unfriendly.
COFFLE|A line of people or animals fastened together, especially a chain of prisoners or slaves.
SWEATSUIT|A two-piece garment worn during exercise.
SUPERMAN|An imagined superior type of human being representing a new stage of human development; an übermensch, an overman.
ESTIVATES|To go into stasis or torpor in the summer months.
RACEHORSE|A horse that competes in races.
GIGANTISM|The quality or state of being gigantic; being of abnormally large size.
SENNA|Any of several plants of the tribe Cassieae, especially those of the genera Cassia and Senna, whose leaves and pods are used as a purgative and laxative.
UNTRUE|False; not true.
GLOBULIN|Any of a group of simple proteins, soluble in water only in the presence of salts, that are coagulated by heat; one of the two parts of haemoglobin.
SIGNIFICANCE|The extent to which something matters; importance
GLUTEN|Fibrin (formerly considered as one of the "animal humours").
GENIPAPS|The North and South American tree Genipa americana of the family Rubiaceae.
MICROTUBULES|A small tube made of protein and found in cells; part of the cytoskeleton.
PLACERS|One who places or arranges something.
BROADTAILS|The hide or fur of a Persian lamb, formerly used in clothing etc.
VOCABLES|A word or utterance, especially with reference to its form rather than its meaning.
SUSPENSEFUL|Inducing suspense.
RATIONALISED|Given a rational explanation
FASCINATIONS|The act of bewitching, or enchanting
KHADI|A coarse homespun cotton cloth from India.
ANIMALISTIC|In the manner of an animal; savage; untamed.
GNATHIC|Of or pertaining to the jaw.
CATALOGS|A systematic list of names, books, pictures etc.
ALUMROOT|Any of several perennial herbs, of the genus Heuchera, native to North America.
CONSERVED|To save for later use, sometimes by the use of a preservative.
SULTAN|The holder of a secular office, formally subordinate to, but de facto the power behind the throne of, the caliph.
CONJUNCTIVAE|A clear mucous membrane that lines the inner surface of the eyelid and the exposed surface of the eyeball or sclera.
COMEDOWN|A sudden drop to a lower status, condition or level; a disappointment or letdown
MISDOUBT|Suspicion; hesitation
GLIMMERED|To shine with a faint, unsteady light.
INKED|Having a tattoo or tattoos.
ALA|A wing or winglike structure.
GUESTED|To appear as a guest, especially on a broadcast
COLLIGATES|To tie or bind together.
CATECHISING|Catechism
SIDEBAR|A short news story printed alongside a larger one.
PROFFERS|An offer made; something proposed for acceptance by another; a tender.
TEFF|A love grass, Eragrostis tef, with small seeds, grown as a cereal and for forage in Ethiopia and parts of Arabia.
EXTERNALISED|To make something external or objective
AH|The speaker or writer, referred to as the grammatical subject, of a sentence.
SABRES|A light sword, sharp along the front edge, part of the back edge, and at the point.
PLANETARIUM|A display museum in which images of stars and other astronomical phenomena are projected onto a domed ceiling.
GASOLIER|A gas-powered chandelier.
DEBATER|One who debates or participates in a debate; one who argues.
EUPHORBIA|Any plant of the genus Euphorbia, the spurges.
EXHUMATION|The act of digging up that which has been buried.
SANITARIUM|An institution that treats chronic diseases, and provides supervised recuperation and convalescence.
OVIFORM|Egg-shaped
DARTS|A pointed missile weapon, intended to be thrown by the hand, for example a short lance or javelin
SWOTS|One who swots.
SPRY|Having great power of leaping or running; nimble; active.
WEIGELAS|Any plant of the genus Weigela.
LESSEE|An individual or a corporation who has the right of use of something of value, gained through a lease agreement with the real owner of the property.
MELLOWER|Soft or tender by reason of ripeness; having a tender pulp.
ATTENDANTS|One who attends; one who works with or watches over something.
PAHOEHOE|A form of lava flow of basaltic rock, usually dark-colored with a smooth or ropey surface. It is one of two chief forms of lava flow emitted from volcanoes of the Hawaiian type, the other form being aa.
ACQUISITIVENESS|The quality of being acquisitive; propensity to acquire property; desire of possession.
STANCHIONS|A vertical pole, post, or support.
DIADEM|An ornamental headband worn as a badge of royalty.
DISABLING|To render unable; to take away an ability of, as by crippling.
ALVEOLI|A small cavity or pit.
QUINTUPLICATES|A set of five similar or identical things.
LIONISED|To treat (a person) as if they were important, or a celebrity.
SPOLIATES|To plunder
CONCOCTS|To prepare something by mixing various ingredients, especially to prepare food for cooking.
SOBERING|(often with up) To make or become sober.
SPLOSHED|To make a heavy splashing sound.
IDENTIFIABLE|Capable of being distinguished and named.
SKYCAPS|A porter at an airport.
ADJUVANTS|Someone who helps or facilitates; an assistant, a helper.
REARMAMENTS|The process of rearming.
GENT|A gentleman.
PERAMBULATE|To walk about, roam or stroll.
ODORIZES|To add an odorant to (especially a gas, so that leaks can be more easily detected).
THRESHERS|Anything or anyone that threshes.
FROM|Used to indicate source or provenance.
COMMONPLACES|A platitude or cliché.
BASSINETS|A newborn baby's bed, typically made of woven reeds or straw.
BLOODROOTS|A North American plant, Sanguinaria canadensis, of the poppy family, which has a red root and sap and a single white flower in early spring.
ISOENZYME|Any of a group of enzymes that catalyze the same reaction but have different structures and physical, biochemical and immunological properties.
TURPENTINE|A volatile essential oil obtained from the wood of pine trees by steam distillation; it is a complex mixture of monoterpenes; it is used as a solvent and paint thinner.
STUTTERED|To speak with a spasmodic repetition of vocal sounds.
RETROVERSION|A turning or falling back.
LIKENED|(followed by to or unto) To compare; to state that (something) is like (something else).
REINTRODUCING|To introduce again.
BUZZCUTS|A closely-cropped military-style haircut.
MOLLIFYING|To ease a burden, particularly worry; make less painful; to comfort.
INSCRIBES|To write or cut (words) onto (something, especially a hard surface, or a book to be given to another person); to engrave.
OVERHYPES|To promote or publicize excessively.
UPROOTED|To root up; to tear up by the roots, or as if by the roots; to extirpate.
NUTTIEST|Containing nuts.
ICKIEST|Unpleasantly sticky; yucky; disgusting.
CARCINOGENESIS|The creation of cancer cells.
MANSLAUGHTERS|The slaying of a human being.
TELETYPES|A teleprinter
WORKOUT|An exercise session; a period of physical exercise.
PRISSIER|Excessively prim, proper, particular or fussy.
GRANDCHILDREN|A child of someone's child.
MELIORATES|To make better; to improve; to solve a problem.
KEROSINE|A petroleum-based thin and colorless fuel
CARPETS|A fabric used as a complete floor covering.
TALAPOIN|A monkey from one of two species of Old World monkeys, of the genus Miopithecus, distinguished by a short-snouted head with a hairless face.
UNAPPEASED|That has not been appeased
MAGMATA|The molten matter within the earth, the source of the material of lava flows, dikes of eruptive rocks, etc.
SLIGHTLY|Slenderly; delicately.
RECRIMINATED|To accuse in return, state an accusation in return.
DISLIKING|To displease; to offend. (In third-person only.)
ASTER|Any of several plants of the genus Aster; one of its flowers.
HECTARE|A unit of surface area (symbol ha) equal to 100 ares (that is, 10,000 square metres, one hundredth of a square kilometre, or approximately 2.5 acres), used for measuring the areas of geographical features such as land and bodies of water.
FAMILIARISING|To make or become familiar with something or someone.
PAGES|One of the many pieces of paper bound together within a book or similar document.
ZESTER|A kitchen implement used to remove the zest of citrus fruit.
POOF|The product of flatulence, or the sound of breaking wind.
PRITHEE|Short for "I pray thee", i.e. Please.
SHERPAS|A mountain guide or porter, particularly a male of the Sherpa people so employed.
VERSIONS|A specific form or variation of something.
NATTERING|To talk casually; to discuss unimportant matters.
WITH|Along, together with others, in a group, etc.
DESERT|(usually in the plural) That which is deserved or merited; a just punishment or reward
KLUDGE|(electronics engineering) An improvised device, typically crudely constructed to test the validity of a principle before doing a finished design.
PROSELYTIZES|To advertise one’s religious beliefs; to convert (someone) to one’s own faith or religious movement or encourage them to do so.
GLUCANS|Any polysaccharide that is a polymer of glucose
UNDERSCORING|To underline; to mark a line beneath text.
LOGICIAN|A person who studies or teaches logic.
GENU|Knee
COERCING|To restrain by force, especially by law or authority; to repress; to curb.
TURRETS|A little tower, frequently a merely ornamental structure at one of the corners of a building or castle.
VEERIES|An American thrush (Catharus fuscescens) common in the Northern United States and Canada.
TILL|Until; to, up to; as late as (a given time).
MONOSOME|The chromosome whose homologous counterpart is missing in monosomy.
HIND|Located at the rear (most often said of animals' body parts).
TEACUPS|A small cup, usually with a handle, used for drinking tea; normally sits in a saucer as part of a tea set.
EMANATION|The act of flowing or proceeding (of something, quality, or feeling) from a source or origin.
ALEXANDRINES|A line of poetic meter having twelve syllables, usually divided into two or three equal parts.
INTRAZONAL|Within a single zone.
CLOUT|Influence or effectiveness, especially political.
STILT|Either of two poles with footrests that allow someone to stand or walk above the ground; used mostly by entertainers.
DISAFFIRMED|To deny, contradict or repudiate
ABUSIVE|Prone to treat someone badly by coarse, insulting words or other maltreatment; vituperative; reproachful; scurrilous.
TEMPORALITIES|The condition of being bounded in time (of being temporal.)
UNESTABLISHED|Not established.
ZEROS|The numeric symbol that represents the cardinal number zero.
MEND|A place, as in clothing, which has been repaired by mending.
SENSUALIST|A person who believes in enjoying sensuality and the experience of pleasant sensations.
SULFONYL|The bivalent radical or functional group -SO2-
COMPETENCY|A sufficient supply (of).
STIMULATION|A pushing or goading toward action.
COMMENDABLE|Worthy of commendation; deserving praise; admirable, creditable, or meritorious.
EMINENCES|Someone of high rank, reputation or social status.
REPRODUCIBLE|(of a measurement, experiment etc) Capable of being reproduced at a different time or place and by different people.
KILLER|One who or that which kills.
CRITIC|A person who appraises the works of others.
SHRIMPED|To fish for shrimp.
SPORTSMANSHIP|The behaviour exhibited in playing sports, either good or bad.
MUSICOLOGIST|One who studies musicology.
NOGGING|To fill in, as between scantling, with brickwork.
ODORIZING|To add an odorant to (especially a gas, so that leaks can be more easily detected).
NONSPECIFIC|Not specific or precise.
HELOTS|A member of the ancient Spartan class of serfs.
SMITHSONITE|A mineral form of zinc carbonate, ZnCO3, mined as an ore of zinc or as an ornamental stone.
NEMATODES|A worm of the large phylum Nematoda, such as a roundworm or threadworm.
STOMATES|Stoma
FLUIDIZES|To give particles of solid the properties of a fluid, either by shaking or by injecting gas
SOLANDERS|A box, in the form of a book, used for keeping botanical specimens etc; drop-spine or clamshell box
SCOOTERS|A kick scooter or push scooter; a human-powered land vehicle with a handlebar, deck and wheels that is propelled by a rider pushing off the ground.
SILUROID|Any catfish of the Siluridae family.
BALLASTING|To stabilize or load a ship with ballast.
SOIGNE|Fashionable and elegant, well-groomed.
SINGULARIZE|To make singular.
NEMERTINES|Any ribbon worm of the phylum Nemertea
JOKINESS|The state or condition of being joky.
REJOICINGS|An act of showing joy.
FRIZZY|A small amount of unkempt, curly hair
FAUCES|The narrow passage from the mouth to the pharynx, situated between the soft palate and the base of the tongue.
ORTHOSES|A type of brace which either prevents or assists movement of a limb or the spine.
SHOEING|To put shoes on one's feet.
UNALIENABLE|Not alienable.
FOREFRONT|The leading position or edge.
SPRINT|A short race at top speed.
SURVEYING|To inspect, or take a view of; to view with attention, as from a high place; to overlook
MOO|The characteristic lowing sound made by cattle.
ORBITED|To circle or revolve around another object.
DREDGERS|A vessel equipped for the removal of sand or sediment from the seabed.
KIPS|The untanned hide of a young or small beast, such as a calf, lamb, or young goat.
UPREARED|To raise something up; to rise up; to erect
GUARDS|A person who, or thing that, protects or watches over something.
LINTELS|A horizontal structural beam spanning an opening, such as between the uprights of a door or a window, and which supports the wall above.
UNCLIPPING|To release something by removing a clip.
SORTITION|Selection by drawing lots
HYPOSTYLE|A building or chamber whose roof is supported on a row of columns.
COMMUNICATION|The act or fact of communicating anything; transmission.
SECONDS|Something that is number two in a series.
SWEETENS|To make sweet to the taste.
ACCOUCHEUR|A person who delivers a baby (in childbirth).
LOGARITHM|For a number x, the power to which a given base number must be raised in order to obtain x. Written \log_b x. For example, \log_{10} 1000 = 3 because 10^3 = 1000 and \log_2 16 = 4 because 2^4 = 16.
VARIX|A varicose, i.e. swollen and knotted, vein
LIVED|To be alive; to have life.
POIND|A seizure of property etc in lieu of a debt; the animal or property so seized
REFERRALS|The act or process of transferring someone or something to another, of sending by reference, or referring.
DIKES|A well-dressed man.
VISA|A permit to enter and leave a country, normally issued by the authorities of the country to be visited.
PAVANS|A native or inhabitant of Padua.
LEAKPROOF|To make resistant to leakage.
SMOCKS|A type of undergarment worn by women; a shift or slip.
MISESTIMATES|To estimate erroneously.
OKAYED|To approve.
CHAMPED|To bite or chew, especially noisily or impatiently.
JUDDERED|To spasm or shake violently.
DRAFTY|Characterized by gusts of wind; windy.
CIRCULARISING|To publicize something by publishing and distributing circulars.
SUBSIST|To survive on a minimum of resources.
REMARKED|To mark again.
WOOLLEN|An item of clothing made from wool
LEISHMANIA|A parasite that causes leishmaniasis, a genus trypanosome protozoa, Leishmania.
REMONSTRANT|One who remonstrates, or issues (usually formal and written) protestations.
PREFIX|Something placed before another
IDOLIZES|To make an idol of, or to worship as an idol.
URINALS|A device or fixture used for urination, particularly:
SENDS|To make something (such as an object or message) go from one place to another.
JENNY|A device for spinning thread from fiber onto multiple spindles (also called spinning jenny).
OVEREMOTIONAL|Showing too much emotion.
HYALOID|The hyaloid membrane
FLANKING|To attack the flank(s) of.
GUIDER|One who guides.
PARTS|A portion; a component.
REFLAGS|To change the flag on a vessel, etc.
PURFLED|To decorate (wood, cloth etc.) with a purfle or ornamental border; to border.
MACHINATE|To devise a plot or secret plan; to conspire.
SUSPIRE|A long, deep breath; a sigh.
UNKIND|Lacking kindness, sympathy, benevolence, gratitude, or similar; cruel, harsh or unjust; ungrateful.
BELL|A percussive instrument made of metal or other hard material, typically but not always in the shape of an inverted cup with a flared rim, which resonates when struck.
GLUT|An excess, too much.
CHEQUERS|One who checks or verifies something.
PROCURE|To acquire or obtain.
SYNECDOCHE|A figure of speech that uses the name of a part of something to represent the whole, or the whole to represent a part.
PISCINAE|A drained basin near a church's altar for the disposal of water from liturgical ablutions.
UNKINDEST|Lacking kindness, sympathy, benevolence, gratitude, or similar; cruel, harsh or unjust; ungrateful.
BAYONETED|To stab with a bayonet.
LIFESPAN|The length of time for which an organism lives.
PHOTOGRAVURES|An intaglio process for printing photographic reproductions in newspapers and books.
SPRADDLED|To spread apart (the legs).
UNTRIMMED|Not trimmed; not made tidy by cutting.
EXTOL|To praise; to make high.
UNTECHNICAL|Not technical.
DAM|A structure placed across a flowing body of water to stop the flow or part of the flow, generally for purposes such as retaining or diverting some of the water or retarding the release of accumulated water to avoid abrupt flooding.
POTENTIATE|To endow with power.
AUGUST|Awe-inspiring, majestic, noble, venerable.
STENOHALINE|Tolerant of only a narrow range of saltwater concentrations. Used of aquatic organisms
SEGUED|To move smoothly from one state or subject to another.
ADJUSTED|To modify.
DISSIDENCE|The state of being dissident; dissent
JEWFISHES|Any of several fish species, principally groupers and similar-appearing fish
INFINITE|Something that is infinite in nature.
CORE|The central part of fruit, containing the kernels or seeds.
REIFIED|To regard something abstract as if it were a concrete material thing
HYPERTHYROIDISM|The excessive production of hormones by the thyroid.
EFFETE|Of substances, quantities etc: exhausted, spent, worn-out.
SPORRANS|A small pouch, usually made of either fur or plain or fur-trimmed leather, which is worn, suspended from a belt or chain, on the front of a kilt and used to hold various items normally carried in trouser pockets.
PRETZEL|A toasted bread or cracker usually in the shape of a loose knot.
SAMOYEDS|A member of the Samoyedic peoples of the Siberian Urals, who speak Samoyedic languages
SEXTETTE|Any group of six people or things.
BRIBING|To give a bribe to; specifically, to ask a person to do something, usually against his/her will, in exchange for some type of reward or relief from potential trouble.
VESTRYMAN|A member of a parochial vestry
PAWKIER|Shrewd, sly; often also characterised by a sarcastic sense of humour.
QUARTAN|A fever whose symptoms recur every four days.
SCEPTICISM|The practice or philosophy of being a skeptic.
UNIFACE|A prehistoric stone tool that has been flaked on one surface only.
BODEGA|A storehouse for maturing wine, a winery.
REAPPEARING|To appear again.
ILLUDE|To delude, fool
RAINPROOF|To make rainproof.
PLUGOLA|Undeclared or illicit publicity or product promotion, especially on radio or television.
FATHOMED|To encircle with outstretched arms, especially to take a measurement; to embrace.
SUBMARINE|A boat that can go underwater.
CONVALESCES|To recover health and strength gradually after sickness or weakness.
JUNCTURE|A place where things join, a junction.
PETROL|Petroleum, a fluid consisting of a mixture of refined petroleum hydrocarbons, primarily consisting of octane, commonly used as a motor fuel.
ELECTROSTATICS|The branch of physics that deals with static electricity; that is, with the force exerted by an unchanging electric field upon a charged object
PRECARIOUSNESS|A state of being uncertain or unstable.
WISEGUYS|One who is insolent or flippant; one who makes jokes or perpetrates pranks.
SESTINA|A highly structured poem consisting of six six-line stanzas followed by a tercet or envoy, for a total of thirty-nine lines.
BOOTLICKING|To seek favor from by fawning, servile behavior.
MALLARD|A common and widespread dabbling duck, Anas platyrhynchos, whose male has a distinctive dark green head.
AMARANTHS|An imaginary flower that does not wither.
GOFER|A worker who runs errands; an errand boy.
FOREORDAINED|To predestine or preordain.
PIN|A needle without an eye (usually) made of drawn-out steel wire with one end sharpened and the other flattened or rounded into a head, used for fastening.
SHOYU|A dark form of soy sauce
HOTBOX|A container maintained at elevated temperatures in order to heat or cook its contents.
FARMSTEADS|The main building of a farm.
LIFERS|A prisoner sentenced to life in prison.
SHAVINGS|A thin, shaved off slice of wood, metal, or other material.
MILLILITER|A unit of measure of capacity, being one thousandth of a litre. Symbol: ml
NONNUCLEAR|Not having nuclear weapons.
REINSERTS|To insert again.
BERRYING|To pick berries.
HUMANITIES|The study of Ancient Greek and Latin, their literature, history, etc., sometimes inclusive of the study of the ancient Mediterranean generally.
MIMING|To mimic.
GERMINATES|Of a seed, to begin to grow, to sprout roots and leaves.
RESIDUUM|The residue, remainder or rest of something
FALCONS|Any bird of the genus Falco, all of which are birds of prey.
DEERHOUNDS|A dog, rather like a large greyhound, originally bred in Scotland for hunting deer
OBTAINED|To get hold of; to gain possession of, to procure; to acquire, in any way.
COAMINGS|On a boat, the vertical side of above-deck structures, such as the coach roof, hatch, and cockpit.
OUTFITTER|A person or shop that sells specialized clothes and equipment.
TRANSPLANT|An act of uprooting and moving (something).
PYROMANIACS|A person suffering from pyromania
SEGUES|An instance of segueing, a transition.
OVERSIZED|Very large; especially of something larger than normal for its type.
INKING|To apply ink to; to cover or smear with ink.
REFUNDING|To return (money) to (someone); to reimburse.
OVERCOMMITS|To make excessive commitments, either beyond one's ability or beyond what is reasonable
PINNACES|A light boat, traditionally propelled by sails, but sometimes a rowboat. Pinnaces are usually messenger boats, carrying messages among the larger ships of a fleet.
SQUEEZING|To apply pressure to from two or more sides at once.
MAUSOLEUMS|A large stately tomb or a building housing such a tomb or several tombs.
STRAP|A long, narrow, pliable strip of leather, cloth, or the like.
ROUNDSMAN|A worker who makes rounds, especially in order to deliver goods.
BORNE|To carry or convey, literally or figuratively.
SASHIMI|A dish consisting of thin slices or pieces of raw fish or meat.
SKIVING|To avoid one's lessons or work (chiefly at school or university); shirk.
DEACTIVATES|To make something inactive or no longer effective
PRIESTED|To ordain as a priest.
PUBLICISING|To make widely known to the public.
ROVED|To shoot with arrows (at).
DOWNTURNS|A downward trend, or the beginnings of one; a decline.
RASPER|A person who, or thing that, rasps or scrapes.
DIPS|A lower section of a road or geological feature.
GLARE|An intense, blinding light.
PERCEPTION|The organisation, identification and interpretation of sensory information.
DOUCHING|To administer a douche to; to shower; to douse
PAPYRI|(usually uncountable) A plant (Cyperus papyrus) in the sedge family, native to the Nile river valley.
NOMAD|A member of a society or class who herd animals from pasture to pasture with no fixed home.
RIPTIDES|A particularly strong tidal current
PROVIDED|To make a living; earn money for necessities.
CENSURES|To criticize harshly.
SWACKED|Drunk.
WIDDLE|Urine.
WITTIER|Wise, having good judgement.
MESOZOAN|Any worm-like, marine parasite of the phylum Mesozoa.
LARIS|The national currency of Georgia, divided into 100 tetri.
FELLOWS|A colleague or partner.
CHERVIL|A leafy herb, Anthriscus cerefolium, resembling parsley.
PAKEHAS|A non-Maori, especially a European New Zealander.
SHADOWBOXES|A diorama
OUTDANCES|To dance better than; to outdo in dancing.
ROGATION|A deeply serious and somber prayer or entreaty.
HEADPIECES|The head; the brain.
UNCONQUERABLE|Not conquerable; indomitable.
SNAGGIEST|Covered in snags, or similar sharp projections.
CORKED|To seal or stop up, especially with a cork stopper.
MILITARISED|To give a military character to something, such as government or organization.
SKINHEAD|Someone with a shaved head.
IDENTIFIES|To establish the identity of someone or something.
BRIEFCASE|A case used for carrying documents, especially for business.
SCALLYWAGS|A disreputable fellow, a good-for-nothing, a scapegrace, a blackguard
OPTATIVE|(grammar) A mood of verbs found in some languages (e.g. Sanskrit, Old Prussian, Ancient Greek), used to express a wish. English does not have inflectional optative forms.
REVAMPED|To renovate, revise, improve or renew.
TAWED|To prepare or dress, as hemp, by beating; to tew.
LEGALISED|To make legal or permit under law. Either by decriminalising something that has been illegal or by specifically permitting it.
PROSE|Language, particularly written language, not intended as poetry.
MONK|A male member of a monastic order who has devoted his life for religious service.
MARGRAVE|A feudal era military-administrative officer of comital rank in the Carolingian empire and some successor states, originally in charge of a border area.
NUKES|A small corner formed by two walls; an alcove.
DISMANTLES|To divest, strip of dress or covering.
TAGLIATELLE|Long, flat ribbons of pasta, originally from Emilia-Romagna, sliced from a rolled-out sheet
RHYTHMICALLY|In a rhythmical manner
ASSAILANT|Someone who attacks or assails another violently, or criminally.
MEATBALLS|A ball of minced or ground meat, seasoned and cooked.
BOLIDE|An extremely bright meteor.
HYPERTEXT|Digital text in which the reader may navigate related information through embedded hyperlinks.
QUENELLES|A light dumpling made of lightly spiced minced meat or fish bound with egg and poached.
MERCHANTABLE|Fit for the market, i.e. suitable for selling for an ordinary price. Sometimes, this is a technical designation for a particular kind or class.
CATCHFLY|Any of several unrelated plants that have sticky leaves on which flies become stuck; especially, the silenes or campions.
WHIMPERING|To cry or sob softly and intermittently.
DESTROYERS|That which destroys something.
UNBRAIDING|To disentangle the strands of a braid
STOREKEEPERS|One who runs a shop, either the owner or manager.
INDEMNIFYING|To secure against loss or damage; to insure.
PROFUSE|To pour out; to give or spend liberally; to lavish; to squander.
PROGRAMMED|To enter a program or other instructions into (a computer or other electronic device) to instruct it to do a particular task.
CYCLAMEN|Any of various flowering plants, of the genus Cyclamen, widely cultivated as a houseplant, having decorative leaves and solitary flowers.
DEROGATE|To partially repeal (a law etc.).
FRATERNIZES|To associate with others in a brotherly or friendly manner.
APPLICANTS|One who applies for something; one who makes a request; a petitioner.
JESSES|A short strap fastened around the leg of a bird used in falconry, to which a leash may be fastened.
TRANSPOSITION|The act or process of transposing or interchanging.
BIS|A bisexual person.
REGISTRY|A building in which things are registered or where registers are kept.
TERMINATION|The process of terminating or the state of being terminated.
MOLESKIN|The fur of a mole.
GREENMAIL|Profiting from an attempted hostile takeover by forcing the target company to buy back the hostile bidder's shares at an inflated price.
BONGING|To pull a bell.
SUPPOSITORIES|A medicine in the form of a small plug that is inserted into a bodily cavity, especially the rectum, vagina or urethra, where it melts at body temperature.
SPHERULITE|A minute spherical crystalline body having a radiated structure, observed in some vitreous volcanic rocks, as obsidian and pearlstone.
CHIPOTLES|A ripe jalapeño pepper, dried and smoked for use in cooking.
SURVEILS|To keep someone or something under surveillance.
CREOSOL|The methoxy phenol 2-methoxy-4-methylphenol that is a constituent of creosote
STRUCTURALISM|A theory of sociology that views elements of society as part of a cohesive, self-supporting structure.
MULTIPLE|A whole number that can be divided by another number with no remainder.
BEEZER|Nose.
ALIKE|Having resemblance or similitude; similar; without difference.
PEERY|That tends to peer; prying, inquisitive, curious.
OUTNUMBER|(stative) to be more in number than somebody or something.
REVEGETATED|(of barren ground) To become recolonized by plants
TYRANNICIDE|The killing of a tyrant.
STINGAREES|A stingray.
QUADRANGLES|A geometric shape with four angles and four straight sides; a four-sided polygon.
FAVORABLY|In a favorable manner.
OCULARS|The eyepiece of a microscope or other optical instrument.
RITES|That which complies with justice, law or reason.
CHONDRULES|A small, round granule, formed from molten rock, found in chondritic meteorites.
HIRELINGS|(usually derogatory) An employee who is hired, often to perform unpleasant tasks with little independence.
DRABBLED|To wet or dirty, especially by dragging through mud.
AESTHETICALLY|In an aesthetic manner; with a pleasing sensory effect.
TORTURER|Someone who tortures.
TRIPOS|A three-legged structure; a tripod.
BADLY|Ill, unwell.
STRIDDEN|To walk with long steps.
MUTINYING|To commit mutiny.
CRAFTSMANSHIP|The quality of being a craftsman.
NONCLINICAL|Not clinical or medical.
WHAMS|A forceful blow
READMIT|To admit, or allow to enter, again.
CANNIBALISED|To eat (parts of) another of one's own species.
PHOTOMOSAICS|A composite image made of individual photographs, normally of the same shape and size, placed together - to show a panoramic view etc.
PIASTER|The subdivision of the South Sudanese pound, equal to 1/100 of a pound
AMEBIASIS|An infectious disease caused by the parasitic protozoan Entamoeba histolytica; amoebic dysentery.
PREPRINTED|To print in advance.
DESICCATOR|A closed glass vessel containing a desiccant (such as silica gel) used in laboratories for drying materials or for keeping them dry.
SAFES|A box, usually made of metal, in which valuables can be locked for safekeeping.
FINGERED|To identify or point out. Also put the finger on. To report to or identify for the authorities, rat on, rat out, squeal on, tattle on, turn in.
INSCRIPTION|The act of inscribing.
UNRECEPTIVE|Not receptive
PREX|(college slang) A president, especially of a university.
NONSUITS|A lawsuit that is dismissed as having been brought without cause, prior to an adjudication on the merits.
HEMMING|To make the sound expressed by the word hem; to hesitate in speaking.
HEATED|To cause an increase in temperature of (an object or space); to cause to become hot (often with "up").
KIMCHI|A Korean dish made of vegetables, such as cabbage or radishes, that are salted, seasoned, and stored in sealed containers to undergo lactic acid fermentation.
ADVISOR|One who offers advice.
STABLISHED|To establish.
WHIPTAIL|Any of many New World lizards, of the genus Cnemidophorus, that have long, slender tails.
ANALOGY|A relationship of resemblance or equivalence between two situations, people, or objects, especially when used as a basis for explanation or extrapolation.
AVOIRDUPOIS|The official system of weights used in the UK between 1856 and 1963. It had been the customary system in London since 1300.
REVIVING|To return to life; to become reanimated or reinvigorated.
SERIOCOMIC|Having both serious and comedic qualities or tendencies.
FIPPLES|The mouthpiece of a ducted flute, or the plug forming the floor of the windway.
UPREARING|To raise something up; to rise up; to erect
RHEBOK|A medium-sized, deerlike South African antelope, Pelea capreolus, having pale-gray, curly fur and straight horns.
RESPRAY|An act of respraying.
ARBITRATOR|A person to whom the authority to settle or judge a dispute is delegated.
WOODS|The substance making up the central part of the trunk and branches of a tree. Used as a material for construction, to manufacture various items, etc. or as fuel.
EDUCATIONESE|The jargon used by educators.
GELSEMIUM|Any of several flowering plants, of the genus Gelsemium, many of which are poisonous.
HUSSY|A housewife or housekeeper.
UNCLEARED|Not cleared.
HORNFELS|Any of a series of contact metamorphic rocks that have been baked and indurated by the heat of intrusive igneous masses and rendered massive, hard, splintery, and in some cases exceedingly tough and durable.
READING|To look at and interpret letters or other information that is written.
SPECIFICITIES|The state of being specific rather than general.
CALLING|(heading) To use one's voice.
TONTINE|A form of investment in which, on the death of an investor, his share is divided amongst the other investors.